10
..........
.==.....=.
........=.
.====.....
..........
..........
.....====.
.=........
.=.....==.
..........
