25
.........................
.........................
.........................
.....===.........===.....
.........................
...=.................=...
...=.................=...
...=.................=...
.........................
==.....................==
.........................
...========...=======....
.........................
...========...=======....
.........................
==.....................==
.........................
...=.................=...
...=.................=...
...=.................=...
.........................
.....===.........===.....
.........................
.........................
.........................
