40
........................................
................=...... =...............
................=.......=...............
................=.......=...............
...=............=.......=...........=...
...=............=.......=...........=...
...======.......=========.......=====...
........=.......................=.......
........=.......................=.......
........=====...............=====.......
............=...............=...........
............=...............=...........
............=====.......=====...........
................=.......=...............
................=.......=...............
................=.......=...............
........................................
........................................
........................................
........................................
........................................
........................................
........................................
........................................
................=.......=...............
................=.......=...............
................=.......=...............
............=====.......=====...........
............=...............=...........
............=...............=...........
........=====...............=====.......
........=.......................=.......
........=.......................=.......
...=.====.......=========.......=====...
...=............=.......=...........=...
...=............=.......=...........=...
................=.......=...............
................=.......=...............
................=.......=...............
........................................
